T121	T119	T117	T115	T113	T111	T109	T107	T105	T103	T101
S121	S119	S117	S115	S113	S111	S109	S107	S105	S103	S101
R121	R119	R117	R115	R113	R111	R109	R107	R105	R103	R101
Q121	Q119	Q117	Q115	Q113	Q111	Q109	Q107	Q105	Q103	Q101				Q100	Q102	Q104	Q106	Q108	Q110	Q112	Q114	Q116	Q118	Q120
P121	P119	P117	P115	P113	P111	P109	P107	P105	P103	P101				P100	P102	P104	P106	P108	P110	P112	P114	P116	P118	P120
O121	O119	O117	O115	O113	O111	O109	O107	O105	O103	O101				O100	O102	O104	O106	O108	O110	O112	O114	O116	O118	O120
N121	N119	N117	N115	N113	N111	N109	N107	N105	N103	N101				N100	N102	N104	N106	N108	N110	N112	N114	N116	N118	N120
M121	M119	M117	M115	M113	M111	M109	M107	M105	M103	M101				M100	M102	M104	M106	M108	M110	M112	M114	M116	M118	M120
L121	L119	L117	L115	L113	L111	L109	L107	L105	L103	L101				L100	L102	L104	L106	L108	L110	L112	L114	L116	L118	L120
K121	K119	K117	K115	K113	K111	K109	K107	K105	K103	K101				K100	K102	K104	K106	K108	K110	K112	K114	K116	K118	K120
J121	J119	J117	J115	J113	J111	J109	J107	J105	J103	J101				J100	J102	J104	J106	J108	J110	J112	J114	J116	J118	J120
I121	I119	I117	I115	I113	I111	I109	I107	I105	I103	I101				I100	I102	I104	I106	I108	I110	I112	I114	I116	I118	I120
H121	H119	H117	H115	H113	H111	H109	H107	H105	H103	H101				H100	H102	H104	H106	H108	H110	H112	H114	H116	H118	H120
G121	G119	G117	G115	G113	G111	G109	G107	G105	G103	G101				G100	G102	G104	G106	G108	G110	G112	G114	G116	G118	G120
F121	F119	F117	F115	F113	F111	F109	F107	F105	F103	F101				F100	F102	F104	F106	F108	F110	F112	F114	F116	F118	F120
E121	E119	E117	E115	E113	E111	E109	E107	E105	E103	E101				E100	E102	E104	E106	E108	E110	E112	E114	E116	E118	E120
D121	D119	D117	D115	D113	D111	D109	D107	D105	D103	D101				D100	D102	D104	D106	D108	D110	D112	D114	D116	D118	D120
C121	C119	C117	C115	C113	C111	C109	C107	C105	C103	C101				C100	C102	C104	C106	C108	C110	C112	C114	C116	C118	C120
B121	B119	B117	B115	B113	B111	B109	B107	B105	B103	B101				B100	B102	B104	B106	B108	B110	B112	B114
						A100	A102	A111	A109	A107	A105	A103	A101				A115	A113	A104	A106