A1 A3 A5 A7

B2 B4 B6 B8

C2 C4 C6

D1 D3 D5 D7

E2 E4 E6 E8

F1 F3 F5 F7 F9

G1 G3 G5 G7 G9

H1 H3 H5 H7

I1 I3 I5 I7